#########################
#  #                 #  #
#  #    ######       #  #
#  #    #            #  #
#  ######               #
#               #####   #
#    ##         #       #
#     #         #       #
#     #         #       #
#########################